3 3 3 0 4 0 1 3 3 3 0 5 0 4 0 0 5 5 5 5 4 4 0 0 5 5 5 5 5 5 5 1 0 5 5 5 5 5 5 5 5 1 0 3 8 3 3 3 3 3 
3 3 7 3 2 2 0 3 8 0 4 2 2 0 2 2 4 2 2 2 2 4 0 2 0 2 2 0 5 2 2 4 2 2 0 0 2 2 2 0 2 4 0 3 3 3 3 3 8 3 
8 3 3 0 2 2 3 3 7 1 0 2 2 2 4 0 2 2 2 1 0 2 2 2 2 4 2 2 2 0 2 2 2 0 2 2 0 5 1 2 0 2 7 3 7 3 8 3 7 3 
3 3 8 4 1 2 8 3 7 3 0 4 1 5 0 5 3 0 4 0 5 3 8 3 7 0 0 1 4 5 5 1 0 0 0 5 5 5 0 4 0 1 3 3 3 3 3 3 3 3 
3 8 3 3 2 0 0 3 3 8 3 7 3 7 3 7 3 8 3 7 3 8 7 8 3 3 7 5 5 5 5 7 8 3 5 5 5 3 7 3 3 8 3 8 7 3 3 7 3 3 
3 3 7 0 0 2 3 3 3 7 3 3 8 8 6 8 3 7 8 3 3 6 3 7 3 7 3 8 5 5 5 3 8 3 7 3 6 3 3 3 7 3 3 3 3 3 7 3 3 3 
3 8 3 5 2 2 3 3 7 3 8 0 0 1 0 4 0 0 0 0 1 0 0 4 5 5 5 5 5 5 5 5 0 0 0 0 0 0 0 0 3 3 8 3 8 3 3 3 3 3 
3 3 8 3 2 4 0 3 3 3 4 2 2 2 2 0 2 2 4 2 2 2 2 0 2 2 2 5 2 2 4 0 0 0 0 0 0 0 0 0 7 3 7 8 3 7 3 3 3 3 
7 3 8 0 2 0 4 3 3 7 3 0 2 2 2 2 1 2 2 2 2 0 2 2 2 1 2 2 0 0 2 2 0 0 0 0 0 0 0 0 3 3 8 3 3 7 3 3 3 3 
3 7 3 1 2 2 3 7 8 8 7 1 0 4 3 7 3 0 0 4 0 2 1 0 0 2 4 0 1 2 0 3 0 2 0 0 0 0 0 0 8 3 3 3 8 3 3 3 3 3 
3 3 3 0 0 2 1 3 3 3 3 7 3 8 3 3 3 7 0 3 3 2 3 8 3 4 3 7 8 2 3 7 3 2 8 3 0 0 0 0 3 3 7 8 3 7 3 3 3 3 
7 0 4 0 2 2 0 3 3 7 3 3 3 8 7 3 8 3 3 7 0 2 1 3 2 0 0 3 1 0 2 3 0 0 4 3 0 0 0 0 7 3 3 3 3 3 3 3 3 3 
2 0 2 2 2 4 5 3 3 3 8 3 3 7 3 7 3 8 8 3 4 0 0 7 0 2 4 8 4 0 2 8 1 2 2 7 0 0 0 0 8 3 8 7 8 3 3 3 3 3 
0 2 0 2 2 0 0 3 8 3 3 6 8 6 3 7 3 6 8 3 0 4 2 3 1 0 1 3 0 2 1 3 0 0 1 3 0 0 0 0 3 3 3 3 7 3 3 3 3 3 
0 3 1 3 3 4 3 3 8 3 0 0 0 0 0 0 0 0 0 3 7 3 3 3 0 3 3 3 3 7 3 7 3 8 0 3 0 0 0 0 8 3 7 3 3 3 3 3 3 3 
3 3 3 3 3 3 3 3 3 3 0 0 0 0 0 0 0 0 0 8 0 3 7 3 3 3 7 3 0 3 8 3 8 0 3 7 0 0 0 0 3 3 3 3 3 3 3 3 3 3 
3 3 3 3 3 3 3 3 3 3 0 0 0 0 0 0 0 0 0 3 0 0 0 3 0 0 0 3 0 0 0 3 0 0 0 3 0 0 0 0 7 8 3 3 3 3 3 3 3 3 
3 3 3 3 3 3 3 3 3 3 0 0 0 0 0 0 0 0 0 3 0 0 0 3 0 0 0 3 0 0 0 3 0 0 0 3 0 0 0 0 3 3 3 3 3 3 3 3 3 3 
3 3 3 3 3 3 3 3 3 3 0 0 0 0 0 0 0 0 0 3 0 0 0 3 0 0 0 3 0 0 0 3 0 0 0 3 0 0 0 0 3 3 3 3 3 3 3 3 3 3 
3 3 3 3 3 3 3 3 3 3 3 3 3 3 3 3 0 3 3 6 3 0 3 6 0 0 3 3 3 0 3 6 3 0 3 0 0 0 0 0 3 3 3 3 3 3 3 3 3 3 
3 3 3 3 3 3 3 3 3 3 0 0 0 0 0 0 0 0 0 0 0 0 0 0 0 0 0 0 0 0 0 0 0 0 0 0 0 0 0 0 3 3 3 3 3 3 3 3 3 3 
3 3 3 3 3 3 3 3 3 3 0 0 0 0 0 0 0 0 0 0 0 0 0 0 0 0 0 0 0 0 0 0 0 0 0 0 0 0 0 0 3 3 3 3 3 3 3 3 3 3 
3 3 3 3 3 3 3 3 3 3 0 0 0 0 0 0 0 0 0 0 0 0 0 0 0 0 0 0 0 0 0 0 0 0 0 0 0 0 0 0 3 3 3 3 3 3 3 3 3 3 
3 3 3 3 3 3 3 3 3 3 0 0 0 0 0 0 0 0 0 0 0 0 0 0 0 0 0 0 0 0 0 0 0 0 0 0 0 0 0 0 3 3 3 3 3 3 3 3 3 3 
9 9 9 9 9 9 9 9 9 9 9 9 9 9 0 0 0 9 9 9 9 9 9 9 9 9 9 0 0 9 9 9 9 9 0 9 9 9 9 9 9 9 9 9 9 9 9 9 9 9 
9 9 9 9 9 9 9 9 9 9 9 9 9 9 0 9 0 9 0 0 0 0 0 0 0 0 9 0 0 9 9 9 9 9 0 0 9 0 0 9 9 9 9 9 9 9 9 9 9 9 
9 9 9 9 9 9 9 9 9 9 9 9 9 9 0 9 0 9 0 9 9 9 0 9 9 0 9 0 0 9 9 9 9 9 0 0 9 0 0 9 9 9 9 9 9 9 9 9 9 9 
9 9 9 9 9 9 9 9 9 9 9 9 9 9 0 9 0 9 0 9 9 9 9 9 9 0 9 0 0 9 0 0 9 9 9 0 0 0 0 0 9 9 9 9 9 9 9 9 9 9 
9 9 9 9 9 9 9 9 9 9 9 9 9 9 0 9 0 9 0 0 0 0 0 0 0 0 9 0 0 9 0 0 9 9 0 0 9 0 0 9 9 9 9 9 9 9 9 9 9 9 
9 9 9 9 9 9 9 9 9 9 9 9 9 9 0 0 0 9 9 9 9 0 9 9 9 9 9 0 0 9 0 0 9 9 0 0 9 0 0 9 9 9 9 9 9 9 9 9 9 9 
9 9 9 9 9 9 9 9 9 9 0 0 0 0 0 0 0 0 0 0 9 0 0 9 0 0 0 0 0 0 0 0 0 0 0 9 9 0 0 9 9 9 9 9 9 9 9 9 9 9 
9 9 9 9 9 9 9 9 9 9 0 0 0 0 0 0 0 0 0 0 9 0 0 9 0 0 0 0 0 0 0 0 0 0 0 0 9 9 9 9 9 9 9 9 9 9 9 9 9 9 
9 9 9 9 9 9 9 9 9 9 0 0 0 9 9 9 9 9 0 0 9 0 0 9 9 9 9 9 9 9 9 9 9 0 0 0 0 0 0 0 9 9 9 9 9 9 9 9 9 9 
9 9 9 9 9 9 9 9 9 9 0 0 0 9 0 0 0 9 0 0 0 0 0 0 0 0 0 0 0 9 0 0 0 0 0 0 0 0 0 0 9 9 9 9 9 9 9 9 9 9 
9 9 9 9 9 9 9 9 9 9 0 9 9 9 0 0 0 9 0 0 0 0 0 0 0 0 0 0 0 0 0 0 0 0 9 0 0 9 0 0 9 9 9 9 9 9 9 9 9 9 
9 9 9 9 9 9 9 9 9 9 0 0 0 9 0 0 0 9 9 9 9 0 0 9 9 9 9 9 9 9 0 0 0 0 9 0 0 9 0 0 9 9 9 9 9 9 9 9 9 9 
9 9 9 9 9 9 9 9 9 9 0 0 0 9 0 0 0 9 0 0 0 0 0 0 0 9 0 0 0 9 9 9 9 9 9 0 0 9 0 0 9 9 9 9 9 9 9 9 9 9 
9 9 9 9 9 9 9 9 9 9 0 0 0 0 0 0 0 9 0 0 0 0 0 0 0 9 0 0 0 0 0 0 0 0 0 0 0 9 0 0 9 9 9 9 9 9 9 9 9 9 
9 9 9 9 9 9 9 9 9 9 9 9 0 0 0 9 9 9 0 0 0 0 0 0 0 9 0 0 0 0 0 0 0 0 0 0 0 9 0 0 9 9 9 9 9 9 9 9 9 9 
9 9 9 9 9 9 9 9 9 9 0 0 0 0 0 0 9 0 0 0 0 0 0 0 0 9 9 9 0 9 9 9 9 9 9 9 9 9 9 9 9 9 9 9 9 9 9 9 9 9 
9 9 9 9 9 9 9 9 9 9 0 0 0 9 0 0 9 9 9 9 9 9 9 3 3 3 3 3 3 3 3 3 3 3 3 3 3 3 3 3 3 9 9 9 9 9 9 9 9 9 
9 9 9 9 9 9 9 9 9 9 0 0 0 9 0 0 9 0 0 0 9 0 0 3 0 0 0 0 0 0 0 0 0 3 0 0 0 0 0 0 3 9 9 9 9 9 9 9 9 9 
9 9 9 9 9 9 9 9 9 9 0 9 9 9 0 0 9 0 0 0 9 0 0 3 0 0 0 0 0 0 0 0 0 3 0 0 0 0 0 0 3 9 9 9 9 9 9 9 9 9 
9 9 9 9 9 9 9 9 9 9 0 0 0 9 0 0 0 0 9 0 9 0 0 0 0 0 0 0 0 0 0 0 0 0 0 0 0 0 0 0 3 9 9 9 9 9 9 9 9 9 
9 9 9 9 9 9 9 9 9 9 0 0 0 9 0 0 9 0 9 0 0 0 0 3 0 0 0 0 0 0 0 0 0 3 0 0 0 0 0 0 3 9 9 9 9 9 9 9 9 9 
9 9 9 9 9 9 9 9 9 9 0 0 0 0 0 0 9 0 9 0 0 0 0 3 0 0 0 0 0 0 0 0 0 3 0 0 0 0 0 0 3 9 9 9 9 9 9 9 9 9 
9 9 9 9 9 9 9 9 9 9 9 9 9 9 9 9 9 9 9 9 9 9 9 3 3 3 3 3 3 3 3 3 3 3 3 3 3 3 3 3 3 9 9 9 9 9 9 9 9 9 
9 9 9 9 9 9 9 9 9 9 9 9 9 9 9 9 9 9 9 9 9 9 9 9 9 9 9 9 9 9 9 9 9 9 9 9 9 9 9 9 9 9 9 9 9 9 9 9 9 9 
9 9 9 9 9 9 9 9 9 9 9 9 9 9 9 9 9 9 9 9 9 9 9 9 9 9 9 9 9 9 9 9 9 9 9 9 9 9 9 9 9 9 9 9 9 9 9 9 9 9 
9 9 9 9 9 9 9 9 9 9 9 9 9 9 9 9 9 9 9 9 9 9 9 9 9 9 9 9 9 9 9 9 9 9 9 9 9 9 9 9 9 9 9 9 9 9 9 9 9 9 
