2 2 2 2 2 2 2 2 2 2 2 2 2 2 2 2 2 2 2 2 2 2 2 2 2 2 2 2 2 2 2 2 2 2 2 2 2 2 2 2 2 2 2 2 2 2 2 2
2 2 2 2 2 2 2 2 2 2 2 2 2 2 2 2 2 2 2 2 2 2 2 2 2 2 2 2 2 2 2 2 2 2 2 2 2 2 2 2 2 2 2 2 2 2 2 2
2 2 2 2 2 2 2 2 2 2 2 2 2 2 2 2 2 2 2 2 2 2 2 2 2 2 2 2 2 2 2 2 2 2 2 2 2 2 2 2 2 2 2 2 2 2 2 2
2 2 2 2 2 2 2 2 2 2 2 2 2 2 2 2 2 2 2 2 2 2 2 2 2 2 2 2 2 2 2 2 2 2 2 2 2 2 2 2 2 2 2 2 2 2 2 2
2 2 2 2 2 2 2 2 2 2 2 2 2 2 2 2 2 2 2 2 2 2 2 2 2 2 2 2 2 2 2 2 2 2 2 2 2 2 2 2 2 2 2 2 2 2 2 2
2 2 2 2 2 2 2 2 2 2 2 2 2 2 2 2 2 2 2 2 2 2 2 2 2 2 2 2 2 2 2 2 2 2 2 2 2 2 2 2 2 2 2 2 2 2 2 2
2 2 2 2 2 2 2 2 2 2 2 2 2 2 2 6 6 6 6 0 0 0 0 0 0 5 5 5 5 5 2 2 2 2 2 2 2 2 2 2 2 2 2 2 2 2 2 2
2 2 2 2 2 2 2 2 2 2 2 0 6 6 6 6 6 6 0 0 1 1 1 1 1 0 5 5 5 5 5 5 5 5 2 2 2 2 2 2 2 2 2 2 2 2 2 2
2 2 2 2 2 2 2 2 2 2 0 0 0 0 0 0 0 0 0 0 1 3 3 3 1 0 0 5 5 5 5 5 5 5 5 5 2 2 2 2 2 2 2 2 2 2 2 2
2 2 2 2 2 2 2 2 2 2 0 1 1 1 1 1 1 0 0 0 1 3 3 3 1 0 0 0 0 5 5 5 5 5 5 5 2 2 2 2 2 2 2 2 2 2 2 2
2 2 2 2 2 2 2 2 2 2 0 1 3 3 3 3 1 0 0 0 1 3 3 3 1 0 6 6 0 0 0 0 5 5 5 5 2 2 2 2 2 2 2 2 2 2 2 2
2 2 2 2 2 2 2 2 2 2 0 1 3 3 3 3 3 3 3 0 1 1 3 1 1 0 6 6 6 0 0 0 0 0 5 5 2 2 2 2 2 2 2 2 2 2 2 2
2 2 2 2 2 2 2 2 2 2 0 1 3 3 3 3 1 0 3 0 0 0 3 0 0 0 0 0 0 0 0 0 0 0 5 5 5 2 2 2 2 2 2 2 2 2 2 2
2 2 2 2 2 2 2 2 2 2 0 1 1 1 1 1 1 0 3 3 3 3 3 3 3 3 3 3 3 3 3 0 0 0 0 5 5 2 2 2 2 2 2 2 2 2 2 2
2 2 2 2 2 2 2 2 2 2 0 0 0 0 0 0 0 0 3 3 3 3 3 3 3 3 3 3 3 3 3 0 0 0 0 5 2 2 2 2 2 2 2 2 2 2 2 2
2 2 2 2 2 2 2 2 2 2 2 0 4 4 4 4 0 0 0 0 0 6 6 6 6 6 0 0 0 3 3 0 0 0 2 2 2 2 2 2 2 2 2 2 2 2 2 2
2 2 2 2 2 2 2 2 2 2 2 0 0 4 4 4 4 4 4 0 0 6 6 6 6 6 0 0 0 3 3 2 2 2 2 2 2 2 2 2 2 2 2 2 2 2 2 2
2 2 2 2 2 2 2 2 2 2 2 2 0 0 4 4 4 0 0 0 0 0 0 0 0 0 0 2 2 3 3 2 2 2 2 2 5 5 5 2 2 2 2 2 2 2 2 2
2 2 2 2 2 2 2 2 2 2 2 2 2 0 0 0 0 0 0 2 2 2 2 2 2 2 2 2 2 3 3 2 2 0 0 6 6 5 5 2 2 2 2 2 2 2 2 2
2 2 2 2 2 2 2 2 2 2 2 2 2 2 2 2 2 2 2 2 2 2 2 2 2 2 2 2 2 3 3 0 0 6 6 6 6 5 5 2 2 2 2 2 2 2 2 2
2 2 2 2 2 2 2 2 2 2 2 2 2 2 2 2 2 2 2 2 2 0 0 0 6 6 6 6 6 4 4 0 6 6 6 6 6 5 5 2 2 2 2 2 2 2 2 2
2 2 2 2 2 2 2 2 2 2 2 2 2 2 2 0 0 0 6 6 6 6 6 6 6 6 6 6 6 4 4 6 6 6 6 6 6 6 5 2 2 2 2 2 2 2 2 2
2 2 2 2 2 2 2 2 2 2 2 2 2 2 0 6 6 6 6 6 6 6 6 6 6 6 6 6 6 4 4 6 6 6 6 6 6 6 6 2 2 2 2 2 2 2 2 2
2 2 2 2 2 2 2 2 2 2 2 2 2 0 6 6 6 6 6 6 6 6 6 6 6 6 6 6 6 4 4 6 6 6 6 6 6 6 6 2 2 2 2 2 2 2 2 2
2 2 2 2 2 2 2 2 2 2 2 2 2 6 6 6 6 6 6 6 6 6 6 6 4 4 4 4 4 4 4 6 6 6 6 6 6 6 6 2 2 2 2 2 2 2 2 2
2 2 2 2 2 2 2 2 2 2 2 2 0 6 6 6 6 6 6 6 6 6 6 6 4 6 6 6 6 4 4 6 6 6 6 6 6 6 6 0 2 2 2 2 2 2 2 2
2 2 2 2 2 2 2 2 2 2 2 0 6 6 6 6 6 6 6 6 6 6 6 6 4 6 6 6 6 4 4 6 6 6 6 6 6 6 6 0 2 2 2 2 2 2 2 2
2 2 2 2 2 2 2 2 2 2 6 6 6 6 4 4 4 4 4 4 6 6 6 6 4 6 6 6 6 4 4 0 1 1 1 1 1 1 1 6 2 2 2 2 2 2 2 2
2 2 2 2 2 2 2 2 2 2 6 6 6 4 4 4 4 4 4 4 4 4 4 4 4 6 6 6 6 4 4 0 1 3 3 3 3 3 1 0 2 2 2 2 2 2 2 2
2 2 2 2 2 2 2 2 2 2 6 6 6 4 4 4 4 4 4 4 6 6 6 6 6 6 6 6 6 4 4 4 3 3 3 3 3 3 1 6 2 2 2 2 2 2 2 2
2 2 2 2 2 2 2 2 2 2 6 6 6 0 4 4 4 4 6 6 6 6 6 6 6 6 6 6 6 6 6 6 1 3 3 3 3 3 1 6 2 2 2 2 2 2 2 2
2 2 2 2 2 2 2 2 2 2 2 6 6 0 0 4 0 6 6 6 6 6 6 6 6 6 6 6 6 6 6 6 1 1 1 1 1 1 1 2 2 2 2 2 2 2 2 2
2 2 2 2 2 2 2 2 2 2 2 2 0 0 0 0 0 6 6 6 6 6 6 6 6 6 6 6 6 6 6 6 0 6 6 0 0 6 6 2 2 2 2 2 2 2 2 2
2 2 2 2 2 2 2 2 2 2 2 2 5 5 5 5 5 5 5 6 6 6 6 6 6 0 5 5 5 5 5 5 5 5 5 5 2 2 2 2 2 2 2 2 2 2 2 2
2 2 2 2 2 2 2 2 2 2 2 2 2 5 5 5 5 5 5 5 5 5 5 5 5 5 5 5 5 5 5 5 5 2 2 2 2 2 2 2 2 2 2 2 2 2 2 2
2 2 2 2 2 2 2 2 2 2 2 2 2 2 2 2 2 2 5 5 5 5 5 5 5 2 2 2 2 2 2 2 2 2 2 2 2 2 2 2 2 2 2 2 2 2 2 2
2 2 2 2 2 2 2 2 2 2 2 2 2 2 2 2 2 2 2 2 2 2 2 2 2 2 2 2 2 2 2 2 2 2 2 2 2 2 2 2 2 2 2 2 2 2 2 2
2 2 2 2 2 2 2 2 2 2 2 2 2 2 2 2 2 2 2 2 2 2 2 2 2 2 2 2 2 2 2 2 2 2 2 2 2 2 2 2 2 2 2 2 2 2 2 2
2 2 2 2 2 2 2 2 2 2 2 2 2 2 2 2 2 2 2 2 2 2 2 2 2 2 2 2 2 2 2 2 2 2 2 2 2 2 2 2 2 2 2 2 2 2 2 2
2 2 2 2 2 2 2 2 2 2 2 2 2 2 2 2 2 2 2 2 2 2 2 2 2 2 2 2 2 2 2 2 2 2 2 2 2 2 2 2 2 2 2 2 2 2 2 2
2 2 2 2 2 2 2 2 2 2 2 2 2 2 2 2 2 2 2 2 2 2 2 2 2 2 2 2 2 2 2 2 2 2 2 2 2 2 2 2 2 2 2 2 2 2 2 2
2 2 2 2 2 2 2 2 2 2 2 2 2 2 2 2 2 2 2 2 2 2 2 2 2 2 2 2 2 2 2 2 2 2 2 2 2 2 2 2 2 2 2 2 2 2 2 2