6 6 6 0 6 0 5 2 2 2 2 2 2 2 2 2 2 2 2 2 2
6 6 6 6 0 5 5 2 2 2 2 2 2 2 2 2 2 2 2 2 2
6 6 0 0 0 5 2 2 2 2 2 2 2 2 2 2 2 2 2 2 2
0 0 0 5 5 2 2 2 2 2 2 2 2 2 2 2 2 2 2 2 2
5 5 5 2 2 2 2 2 2 2 2 2 2 2 2 2 2 2 2 2 2
2 2 2 2 2 2 2 2 2 2 2 2 2 2 2 2 2 2 2 2 2
2 2 2 2 2 2 2 2 2 2 2 2 2 2 2 2 2 2 2 2 2
2 2 2 2 2 2 2 2 2 2 2 2 2 2 2 2 5 5 5 5 5
2 2 2 2 2 2 2 2 2 2 2 2 2 2 5 5 0 0 6 6 6
2 2 2 2 2 2 2 2 2 2 2 2 5 5 0 6 6 6 1 1 1
2 2 2 2 2 2 2 2 2 2 2 5 0 6 6 4 4 6 1 3 3
2 2 2 2 2 2 2 2 2 5 5 0 0 4 4 4 4 0 1 3 3
2 2 2 2 2 2 2 2 5 5 0 6 6 0 6 6 6 6 1 3 3