4 4 4 0 4 0 6 5 5 5 5 5 5 5 5 5 5 5 5 5 5
4 4 4 4 0 6 6 5 5 5 5 5 5 5 5 5 5 5 5 5 5
4 4 0 0 0 6 5 5 5 5 5 5 5 5 5 5 5 5 5 5 5
0 0 0 6 6 5 5 5 5 5 5 5 5 5 5 5 5 5 5 5 5
6 6 6 5 5 5 5 5 5 5 5 5 5 5 5 5 5 5 5 5 5
5 5 5 5 5 5 5 5 5 5 5 5 5 5 5 5 5 5 5 5 5
5 5 5 5 5 5 5 5 5 5 5 5 5 5 5 5 5 5 5 5 5
5 5 5 5 5 5 5 5 5 5 5 5 5 5 5 5 6 6 6 6 6
5 5 5 5 5 5 5 5 5 5 5 5 5 5 6 6 0 0 4 4 4
5 5 5 5 5 5 5 5 5 5 5 5 6 6 0 4 4 4 3 3 3
5 5 5 5 5 5 5 5 5 5 5 6 0 4 4 1 1 4 3 2 2
5 5 5 5 5 5 5 5 5 6 6 0 0 1 1 1 1 0 3 2 2
5 5 5 5 5 5 5 5 6 6 0 4 4 0 4 4 4 4 3 2 2